████████████████████████████████████████████████████████████████████████████████
████████████████████████████████████████████████████████████████████████████████
████████████████████████████████████████████████████████████████████████████████
████████████████████████████████████████████████████████████████████████████████
████████████████████████████████████████████████████████████████████████████████
████████████████████████████████████████████████████████████████████████████████
████████████████████████████████████████████████████████████████████████████████
████████████████████████████████████████████████████████████████████████████████
████████████████████████████████████████████████████████████████████████████████
████████████████████████████████████████████████████████████████████████████████
████████████████████████████████████████████████████████████████████████████████
████████████████████████████████████████████████████████████████████████████████
████████████████████████████████████████████████████████████████████████████████
████████████████████████████████████████████████████████████████████████████████
████████████████████████████████████████████████████████████████████████████████
████████████████████████████████████████████████████████████████████████████████
████████████████████████████████████████████████████████████████████████████████
████████████████████████████████████████████████████████████████████████████████
████████████████████████████████████████████████████████████████████████████████
████████████████████████████████████████████████████████████████████████████████
████████████████████████████████████████████████████████████████████████████████
████████████████████████████████████████████████████████████████████████████████
████████████████████████████████████████████████████████████████████████████████
████████████████████████████████████████████████████████████████████████████████
████████████████████████████████████████████████████████████████████████████████
███████████████████████████████████p.....███████████████████████████████████████
███████████████████████████████████......██████████.████.█████.█████████████████
█████████████████████████████████████.....................................██████
██████████████████████████████████████████.██████.██████.█████████.██████.██████
█████████████████████████████████████....█.██████.████████████████..█████.p█████
█████████████████████████████████████.██.█.██████.████████████████.█████████████
█████████████████████████████████████..p.█........█████████.........████████████
███████████████████████████████████...████.██████████████...p..█....████████████
███████████████████████████████████.█......███████████████...█....██████████████
██████████████████████████████████████████.████████████████.....████████████████
██████████████████████████████████████████.█████████████████████████████████████
████████..............█..p..███....█...█..p..█....█....█████████████████████████
████████.██.████.██.███.█.█.███.████.█.█.█.█.█.████.████████████████████████████
████████.██...██.██.....█.█.....█......█.█.█.█....█.....████████████████████████
████████.████.██.██.███.█.█.███.██.█.█.█.█.█...████████...██████████████████████
████████.██...██.██...█.█.█.███....█.█...█.█.█..........█.██████████████████████
████████..██████████.████████████████████████████████████...████████████████████
███████...........p█.█............███████████████████████.█.████████████████████
████████.███████████.████████.███.██████████████████████..██████████████████████
████████......................███........████████████.....██████████████████████
████████████.███████.██████████████████.████████████........████████████████████
████████████████.....█████████..........█████████p...█......████████████████████
███████████████████████████.....███████.████████████.█....█.████████████████████
███████████████████████████.....███████.████████████.█..p.█.████████████████████
███████████████████████████..p..██..........████████.█....█..███████████████████
███████████████████████████.....██.█..█.█..█████████.██████..███████████████████
█████████████████████████████████..█..█.█..██................███████████████████
██████████████████████████████████.████.██.██.██████████████████████████████████
████████████████████████████████..............██████████████████████████████████
███████████████████████████████████████.█████.██████████████████████████████████
███████████████████████████████████████p█..██.██████████████████████████████████
███████████████████████████████████████.██.██.██████████████████████████████████
███████████████████████████████████████.██.██.██████████████████████████████████
███████████████████████████████████████s██....██████████████████████████████████
████████████████████████████████████████████████████████████████████████████████