█████████████
██p..█.#...██
████...███p██
█████.███████
█████s███████
█████████████